111111
100101
1C0E01
1P0011
111111
