11111111
10E00001
100C0001
10000001
10P00001
10000001
10000011
11111111
