111111111111111111111111
1000000E0000000C00000C01
101001010010000010100101
101001001010101000100101
1P0000000C00C00000000001
111111111111111111111111
