111111111111111111111111
1E0000001000100C1C1001C1
101001100010001010100101
111111111111111010100101
1P0000000C00C00000000001
111111111111111111111111
