111111
1CC101
1CCE01
1P0001
111111
